Gs^Fds, Gs^Fds, Gs^Fds, Gs^Fds, Gs^Fds, Gs^Fds, Gs^Fds, Gs^Fds, Gs^Fds, Gs^Fds, Gs^Fds, Gg, Gg, Gg, Hh, Hh, Mm, Mm, Mm, Mm, Hh, Gg, Gg, Gg, Gg, Gg, Hh, Hh, Mm, Mm, Mm, Mm, Mm, Mm, Hh, Hh, Hh, Gg, Gs^Fds, Gs^Fds, Gs^Fds, Gs^Fds, Gs^Fds, Gs^Fds, Gs^Fds, Gs^Fds
Gs^Fds, Gs^Fds, Gs^Fds, Gs^Fds, Gs^Fds, Gs^Fds, Gs^Fds, Gs^Fds, Gs^Fds, Gs^Fds, Gs^Fds, Gg, Gg, Gg, Hh, Hh, Mm, Mm, Mm, Mm, Hh, Gg, Gg, Gg, Gg, Gg, Gs^Fds, Hh, Hh, Mm, Mm, Mm, Mm, Mm, Mm, Hh, Hh, Hh, Gs^Fds, Gs^Fds, Gs^Fds, Gs^Fds, Gs^Fds, Gs^Fds, Gs^Fds, Gs^Fds
Gs^Fds, Gs^Fds, Gs^Fds, Gs^Fds, Gs^Fds, Gs^Fds, Gs^Fds, Gs^Fds, Gs^Fds, Gs^Fds, Gs^Fds, Gg, Gg, Hh, Hh, Mm, Mm, Mm, Mm, Hh, Hh, Hh, Gg, Gg, Gg, Gs^Fds, Gs^Fds, Hh, Hh, Mm, Mm, Mm, Mm, Mm, Mm, Mm, Mm, Hh, Hh, Gs^Fds, Gs^Fds, Gs^Fds, Gg, Gg, Gg, Gg
Gs^Fds, Gs^Fds, Gs^Fds, Gs^Fds, Gs^Fds, Gs^Fds, Gs^Fds, Gs^Fds, Gs^Fds, Gs^Fds, Gg, Gg, Hh, Hh, Mm, Mm, Mm, Mm, Hh, Hh, Hh, Gg, Gg, Gg, Gg, Gg, Gs^Fds, Gs^Fds, Hh, Mm, Mm, Mm, Mm, Mm, Mm, Mm, Mm, Hh, Hh, Gg, Gg, Gg, Gg, Gg, Gg, Gg
Gs^Fds, Gs^Fds, Gs^Fds, Gs^Fds, Gs^Fds, Gs^Fds, Gs^Fds, Gs^Fds, Gg, Gg, Hh, Hh, Hh, Hh, Mm, Mm, Mm, Mm, Hh, Hh, Gs^Fds, Gs^Fds, Gg, Gg, Gg, Gg, Gg, Gs^Fds, Gs^Fds, Hh, Hh, Mm, Mm, Mm, Mm, Mm, Mm, Mm, Mm, Hh, Hh, Gg, Gg, Gg, Gg, Gg
Gs^Fds, Gs^Fds, Gs^Fds, Gs^Fds, Gs^Fds, Gs^Fds, Gg, Gg, Hh, Hh, Hh, Hh, Mm, Mm, Mm, Mm, Mm, Mm, Hh, Gs^Fds, Gs^Fds, Gs^Fds, Gg, Gg, Gg, Gg, Gg, Gs^Fds, Gs^Fds, Hh, Hh, Hh, Hh, Mm, Mm, Mm, Mm, Mv, Mm, Mm, Hh, Gg, Gg, Gg, Gs^Fds, Gg
Gg, Gs^Fds, Gs^Fds, Gs^Fds, Gg, Gg, Hh, Hh, Hh, Hh, Mm, Mm, Mm, Mm, Mm, Mm, Hh, Hh, Hh, Gs^Fds, Gs^Fds, Rr^Vd, Gg, Gg, Gg, Gg, Gg, Gg, Gg, Hh, Hh, Hh, Hh, Hh, Hh, Mm, Mm, Mm, Mm, Mm, Hh, Gg, Gs^Fds, Gs^Fds, Gs^Fds, Gs^Fds
Gg, Gg, Gg, Gg, Gg, Gg, Hh, Hh, Mm, Mm, Mm, Mm, Mm, Mm, Hh, Hh, Hh, Hh, Gs^Fds, Gs^Fds, Gg, Gg, Gg, Gg, Gg, Gg, Gg, Gg, Gg, Gs^Fds, Gs^Fds, Hh, Hh, Hh, Hh, Mm, Mm, Mm, Mm, Mm, Hh, Gs^Fds, Gs^Fds, Gs^Fds, Gs^Fds, Gs^Fds
Gs^Fds, Gg, Gs^Fds, Gg, Gg, Hh, Hh, Mm, Mm, Mm, Mm, Mm, Hh, Hh, Hh, Hh, Gs^Fds, Gs^Fds, Gg, Gg, Gg, Gg, Gg, Gg, Gg, Gg, Gg, Gg, Gg, Gs^Fds, Gs^Fds, Gs^Fds, Gs^Fds, Hh, Hh, Mm, Mm, Mm, Mm, Mm, Hh, Gs^Fds, Gs^Fds, Gs^Fds, Gs^Fds, Gs^Fds
Gs^Fds, Gs^Fds, Gs^Fds, Gs^Fds, Gg, Hh, Hh, Mm, Mm, Mv, Mm, Mm, Hh, Hh, Hh, Gs^Fds, Gs^Fds, Gs^Fds, Gg, Gg, Gg, Gg, Gg, Gg, Gg, Gg, Gg, Gg, Gg, Rr^Vd, Gs^Fds, Gs^Fds, Gs^Fds, Hh, Hh, Mm, Mm, Mm, Mm, Mm, Hh, Gs^Fds, Gs^Fds, Gs^Fds, Gs^Fds, Gs^Fds
Gs^Fds, Gs^Fds, Gs^Fds, Gs^Fds, Gg, Gg, Hh, Mm, Mm, Mm, Mm, Hh, Hh, Hh, Gs^Fds, Gs^Fds, Gs^Fds, Gg, Gg, Gg, Gg, Gg, Gg, Gg, Gg, Gg, Gg, Gg, Gg, Gg, Gg, Gs^Fds, Gs^Fds, Hh, Hh, Mm, Mm, Mm, Mm, Hh, Hh, Gg, Gs^Fds, Gs^Fds, Gs^Fds, Gs^Fds
Gs^Fds, Gs^Fds, Gs^Fds, Gs^Fds, Gs^Fds, Gg, Hh, Mm, Mm, Mm, Hh, Hh, Hh, Gs^Fds, Gs^Fds, Gs^Fds, Gg, Gg, Gg, Gg, Gg, Gg, Gg, Gg, Ww, Gg, Gg, Gg, Gg, Gg, Gg, Gs^Fds, Gs^Fds, Hh, Hh, Mm, Mm, Mm, Mm, Hh, Hh, Gg, Gg, Gs^Fds, Gs^Fds, Gs^Fds
Gs^Fds, Gs^Fds, Gs^Fds, Gs^Fds, Gs^Fds, Hh, Hh, Mm, Mm, Mm, Hh, Hh, Hh, Gs^Fds, Gs^Fds, Gs^Fds, Gg, Gg, Gg, Gg, Gg, Gg, Ww, Ww, Ww, Ww, Ww, Ww, Ww, Gg, Gg, Gg, Gs^Fds, Hh, Hh, Mm, Mm, Mv, Mm, Hh, Hh, Gg, Gg, Gg, Gg, Gs^Fds
Gs^Fds, Gs^Fds, Gs^Fds, Gs^Fds, Gg, Hh, Hh, Mm, Mm, Mm, Hh, Hh, Gs^Fds, Gs^Fds, Gg, Gg, Gg, Gg, Gg, Gg, Ww, Ww, Wo, Wo, Ww, Ww, Ww, Ww, Ww, Ww, Ww, Gg, Gg, Hh, Hh, Mm, Mm, Mm, Mm, Hh, Gg, Gg, Gg, Gg, Gg, Gg
Gg, Gg, Gg, Gg, Hh, Hh, Mm, Mm, Mm, Mm, Hh, Hh, Rr^Vd, Gg, Gg, Gg, Gg, Gg, Ww, Ww, Ww, Wo, Ww, Ww, Gg, Gg, Gg, Ww, Ww, Ww, Ww, Ww, Ww, Gg, Gg, Mm, Mm, Mm, Hh, Hh, Gg, Gg, Gg, Gg, Gg, Gg
Gg, Gg, Gg, Gg, Hh, Hh, Mm, Mm, Mm, Mm, Hh, Hh, Gg, Gg, Gg, Gg, Ww, Ww, Ww, Ww, Ww, Ww, Gg, Gg, Gg, Gg, Gs^Fds, Gs^Fds, Rr^Vd, Ww, Ww, Wo, Wo, Ww, Ww, Gg, Gg, Gg, Gg, Gg, Gg, Gg, Ww, Gg, Ww, Ww
Gg, Gg, Gg, Gg, Hh, Hh, Mm, Mv, Mm, Mm, Hh, Hh, Gg, Gg, Ww, Ww, Wo, Wo, Ww, Ww, Gg, Gg, Gg, Gg, Gg, Gs^Fds, Gs^Fds, Hh, Mm, Gg, Gs^Fds, Ww, Ww, Wo, Wo, Ww, Ww, Gg, Ww, Gg, Ww, Ww, Wo, Ww, Ww, Ww
Gg, Gg, Gg, Gg, Hh, Mm, Mm, Mm, Mm, Hh, Hh, Gg, Ww, Ww, Wo, Wo, Ww, Ww, Gg, Gg, Gg, Gg, Gg, Gg, Gg, Gs^Fds, Mm, Mm, Mv, Mm, Mm, Gs^Fds, Gs^Fds, Ww, Ww, Ww, Wo, Ww, Wo, Ww, Ww, Wo, Ww, Wo, Ww, Ww
Gg, Gg, Gg^Efm, Hh, Gs^Fds, Hh, Hh, Hh, Hh, Hh, Ww, Ww, Ww, Ww, Ww, Ww, Gg, Gg, Gs^Fds, Gs^Fds, Gs^Fds, Gs^Fds, Gg, Gg, Gg, Hh, Mm, Mm, Mm, Mm, Mm, Hh, Gs^Fds, Gs^Fds, Gg, Ww, Ww, Wo, Ww, Ww, Ww, Ww, Gs^Fds, Ww, Gg, Gg
Gg, Gg^Efm, Gs^Fds, Gs^Fds, Gs^Fds, Gs^Fds, Gg, Hh, Gg, Gg, Ww, Wo, Wo, Ww, Gg, Gg, Rr^Vd, Hh^Ebn, Hh, Gs^Fds, Gs^Fds, Gs^Fds, Gs^Fds, Gg, Gg, Hh, Gg, Mm, Mm, Mm, Hh, Hh^Ebn, Gg, Gg, Gg, Gg, Gg, Ww, Gg, Ww, Gg, Gs^Fds, Gs^Fds, Gs^Fds, Gs^Fds, Gg
Gs^Fds, Gs^Fds, Gs^Fds, Gs^Fds, Gs^Fds, Gs^Fds, Gg, Gg, Gg, Ww, Ww, Wo, Wo, Ww, Gg, Hh, Hh, Hh, Mm, Hh, Hh, Gs^Fds, Gs^Fds, Gg, Gg, Gg, Gg, Gg, Gg, Rr^Vd, Hh, Hh, Gg, Gg, Gg, Gg, Gg, Gg, Gg, Gg, Gg, Gs^Fds, Gs^Fds, Gs^Fds, Gs^Fds, Gs^Fds
Gs^Fds, Gs^Fds, Gs^Fds, Gs^Fds, Gg, Gg, Gg, Gg, Ww, Ww, Ww, Ww, Ww, Ww, Gg, Mm, Mm, Mm, Mm, Hh, Hh, Gs^Fds, Gs^Fds, Gg, Gg, Gg, Ce, Gg, Gg, Gg, Gs^Fds, Gg, Gs^Fds, Hh, Hh, Hh, Hh, Hh, Hh, Gg, Gg, Gg, Gs^Fds, Gs^Fds, Gs^Fds, Gs^Fds
Gg, Gs^Fds, Gg, Gg, Gg, Gg, Gg, Ww, Ww, Ww, Wo, Wo, Ww, Ww, Hh, Mm, Mm, Mv, Mm, Mm, Hh, Gs^Fds, Gs^Fds, Gg, Gg, Gg, Ce, Ce, Gg, Gs^Fds, Gs^Fds, Gs^Fds, Gs^Fds, Hh, Mm, Mm, Mm, Hh^Ebn, Hh, Gg, Gg, Gg, Gg, Gs^Fds, Gs^Fds, Gs^Fds
Gg, Gg, Gg, Gg, Gg, Gg, Ww, Ww, Ww, Ww, Wo, Wo, Ww, Gg, Gg, Mm, Mm, Mm, Mm, Mm, Gs^Fds, Gs^Fds, Gg, Gg, Gg, Gg, Ke, Ce, Gg, Gg, Gs^Fds, Gs^Fds, Gs^Fds, Mm, Mm, Mm, Mm, Hh, Hh, Gg, Gg, Rr^Vd, Gg, Gs^Fds, Gs^Fds, Gs^Fds
Gg, Gg, Gg, Gg, Ww, Ww, Ww, Ww, Ww, Wo, Ww, Ww, Gg, Gg, Gg, Mm, Gg, Mm, Gg, Gg, Gg, Gg, Gg, Gg, Gg, Gg, Gg, Gg, Gg, Gg, Gg, Gs^Fds, Gs^Fds, Gs^Fds, Mm, Mv, Mm, Mm, Gs^Fds, Gs^Fds, Gs^Fds, Gg, Gs^Fds, Gs^Fds, Gs^Fds, Gs^Fds
Gg, Gg, Ww, Ww, Ww, Ww, Wo, Ww, Ww, Ww, Gg, Gg, Gs^Fds, Gg, Gg, Gg, Gg, Gg, Gg, Gg, Gg, Gg, Gg, Gg, Gg, Gg, Gg, Gg, Gg, Gg, Gg, Gg, Gs^Fds, Mm, Mm, Mm, Mm, Mm, Gs^Fds, Gs^Fds, Gs^Fds, Gs^Fds, Gs^Fds, Gs^Fds, Gs^Fds, Gs^Fds
Ww, Ww, Ww, Ww, Wo, Wo, Ww, Ww, Hh, Gg, Hh, Gs^Fds, Hh, Gs^Fds, Gs^Fds, Gg, Gg, Gg, Gg, Rr^Vd, Gg, Gg, Gg, Gg, Hh, Hh, Hh, Gg, Gs^Fds, Gs^Fds, Gg, Gg, Gg, Gg, Mm, Mv, Mm, Mm, Gs^Fds, Gs^Fds, Gs^Fds, Gs^Fds, Gs^Fds, Gs^Fds, Gs^Fds, Gs^Fds
Ww, Ww, Wo, Ww, Ww, Ww, Gg, Gg, Mm, Hh, Mm, Mm, Hh, Gs^Fds, Gs^Fds, Gg, Gg, Gg, Gg, Gg, Gg, Gg, Hh, Hh, Hh, Hh, Hh, Hh, Hh, Gs^Fds, Gs^Fds, Gg, Gg, Gs^Fds, Mm, Mm, Mm, Mm, Mm, Gs^Fds, Gs^Fds, Gs^Fds, Gs^Fds, Gs^Fds, Gs^Fds, Gs^Fds
Ww, Ww, Wo, Ww, Ww, Gg, Gg, Hh, Mm, Mm, Mm, Mm, Hh, Gs^Fds, Gs^Fds, Gg, Gs^Fds, Gs^Fds, Gs^Fds, Gs^Fds, Gs^Fds, Gg, Hh, Hh^Ebn, Hh, 1 Hh, Hh, Hh^Ebn, Hh, Gs^Fds, Gs^Fds, Gg, Gg, Gs^Fds, Hh, Mm, Rr^Vd, Mm, Mm, Mm, Mm, Gs^Fds, Gs^Fds, Gs^Fds, Gs^Fds, Gs^Fds
Ww, Ww, Wo, Ww, Gg, Gg, Hh, Hh, Mm, Mv, Mm, Mm, Gs^Fds, Gs^Fds, Gg, Gg, Gs^Fds, Gs^Fds, Hh, Gs^Fds, Gs^Fds, Gg, Gg, Hh, Hh, Hh, Hh, Hh, Gs^Fds, Gs^Fds, Gs^Fds, Gg, Gg, Gs^Fds, Gs^Fds, Hh, Hh, Mm, Mm, Mm, Mm, Mm, Mm, Gs^Fds, Gs^Fds, Gs^Fds
Ww, Ww, Ww, Ww, Hh, Hh, Mm, Mm, Mm, Mm, Mm, Mm, Gs^Fds, Gs^Fds, Rr^Vd, Gg, Hh, Hh, Hh, Hh, Gs^Fds, Gs^Fds, Gg, Gg, Rr^Vd, Hh, Hh, Hh, Gs^Fds, Gs^Fds, Gg, Gg, Gg, Gg, Gs^Fds, Gs^Fds, Hh, Hh, Hh, Mm, Mm, Mm, Mm, Gg, Gg, Gs^Fds
Ww, Ww, Hh, Hh, Mm, Mm, Mm, Mm, Mm, Mm, Hh, Gs^Fds, Gs^Fds, Gs^Fds, Gg, Gg, Hh, Hh, Hh, Hh^Ebn, Hh, Gs^Fds, Gs^Fds, Gg, Gg, Gg, Gs^Fds, Gs^Fds, Gs^Fds, Gs^Fds, Gg, Gg, Gg, Gg, Gg, Gs^Fds, Gg, Hh, Hh, Hh, Hh^Ebn, Mm, Mm, Mm, Hh, Gg
Gg, Gg, Gg, Hh, Mm, Mm, Mm, Mm, Hh^Ebn, Hh, Gs^Fds, Gs^Fds, Gg, Gg, Gg, Hh, Hh, Hh, Hh, Hh, Hh, Hh, Gs^Fds, Gg, Gg, Gg, Gg, Gg, Gg, Gg, Gg, Gg, Gg, Gg, Gg, Gg, Gg, Gg, Gg, Gg, Gg, Hh, Hh, Mm, Hh, Hh
Gg, Gg, Gg, Hh, Gg, Mm, Hh, Hh, Hh, Hh, Gg, Gg, Gg, Gg, Gg, Gg, Hh, Hh^Ebn, Hh, Hh, Hh, Hh, Gg, Gg, Gg, Gg, Gg, Gg, Gg, Gg, Gg, Gg, Gg, Gg, Gg, Gg, Gg, Gg, Gg, Gg, Gg, Gg, Gg, Hh, Gg, Gg
Gg, Gg, Gg, Gg, Gg, Hh, Hh, Hh, Gg, Gg, Gg, Gg, Gg, Gg, Gg, Gg, Gg, Hh, Gg, Hh, Gg, Gg, Gg, Gg, Gg, Gg, Gg, Gg, Gg, Gg, Gg, Gg, Gg, Gg, Gg, Gg, Gg, Gg, Gg, Gg, Gg, Gg, Gg, Gg, Gg, Gg
