Ms, Ms, Ms, Ms, Ms, Ms, Ms, Ms, Ms, Ms, Xu, Xu, Xu, Ms, Ms, Ms, Ms, Ms, Ms, Ms, Ms, Ms, Ms, Ms
Ms, Ms, Ms, Ms, Ms, Ms, Ms, Ms, Xu, Xu, Xu, Xu, Xu, Xu, Xu, Ms, Ms, Ms, Ms, Ms, Ms, Ms, Ms, Ms
Ms, Ms, Ms, Ms, Ms, Ms, Xu, Xu, Xu, Xu, Uh, Uh, Uh, Xu, Xu, Xu, Xu, Ms, Ms, Ms, Ms, Ms, Ms, Ms
Ms, Ms, Ms, Ms, Ms, Ms, Xu, Xu, Xu, Qxu, Uu, Uu, Uu, Uh, Uh, Xu, Xu, Xu, Xu, Ms, Ms, Ms, Ms, Ms
Ms, Ms, Ms, Ms, Ha, Ha, Ha, Xu, Xu, Xu, Xu, Uu, Uu, Uu, Uu, Qxu, Xu, Xu, Xu, Ms, Ms, Ms, Ms, Ms
Ms, Ms, Ms, Ms, Ha, Ha, Aa^Fda, Aa^Fda, Aa^Fda, Xu, Xu, Uu, Uu, Uu, Xu, Xu, Xu, Xu, Ha, Ha, Ms, Ms, Ms, Ms
Ms, Ms, Ms, Ha, Ha, Ha, Aa, Aa^Fda, Aa, Aa, Aa, Aa, Aa, Aa, Aa, Xu, Aa^Fda, Ha, Ha, Ha, Ms, Ms, Ms, Ms
Ms, Ms, Ms, Ha, Ha, Ha, Aa, Aa, Aa, Aa, Aa, Re, Re, Aa, Aa^Feta, Aa, Aa^Fda, Ha, Ha, Ms, Ms, Ms, Ms, Ms
Ms, Ms, Ms, Ha, Ha, Ha, Re, Re, Re, Aa, Aa, Aa, Re, Re, Aa, Aa, Aa^Fda, Ha, Ha, Ha, Ms, Ms, Ms, Ms
Ms, Ms, Ms, Ha, Ha, Ha, Aa^Fda, Aa^Fda, Aa, Aa, Aa, Aa, Aa, Aa, Aa, Re, Re, Ha, Ha, Ha, Ms, Ms, Ms, Ms
Ms, Ms, Ms, Ha, Ha, Ha, Aa^Fda, Aa^Fda, Aa^Vla, Aa^Feta, Aa, Aa, Re, Aa, Aa, Aa, Re, Ha, Ha, Ha, Ms, Ms, Ms, Ms
Ms, Ms, Ms, Ha, Ha, Ha, Aa^Fda, Aa^Fda, Aa, Aa, Aa, Re, Aa, Aa, Aa, Aa^Vla, Aa^Fda, Ha, Ha, Ha, Ms, Ms, Ms, Ms
Ms, Ms, Ms, Ha, Ha, Ha, Aa^Fda, Aa^Fda, Aa, Aa, Aa, Re, Aa, Aa, Aa, Aa^Fda, Aa^Fda, Ha, Ha, Ha, Ms, Ms, Ms, Ms
Ms, Ms, Ms, Ha, Ha, Ha, Aa, Aa^Fda, Aa, Aa, Aa, Aa, Re, Aa, Aa, Aa^Fda, Aa^Fda, Ha, Ha, Ha, Ms, Ms, Ms, Ms
Ms, Ms, Ms, Ms, Ha, Ha, Aa, Aa, Aa, Aa, Aa, Re, Re, Aa, Aa, Aa^Fda, Aa^Fda, Ha, Ha, Ha, Ms, Ms, Ms, Ms
Ms, Ms, Ms, Ms, Ha, Ha, Aa^Fda, Aa^Fda, Aa, Aa, Aa, Aa, Re, Aa, Aa, Aa^Fda, Aa^Fda, Aa^Fda, Ha, Ha, Ms, Ms, Ms, Ms
Ms, Ms, Ms, Ms, Ha, Ha, Aa^Fda, Aa^Fda, Aa, Aa, Aa, Aa, Aa, Aa, Aa, Aa, Aa, Aa^Fda, Aa^Vla, Ha, Ha, Ms, Ms, Ms
Ms, Ms, Ms, Ms, Ha, Ha, Aa, Aa, Aa, Aa, Aa, Re, Re, Aa, Aa, Aa^Feta, Aa, Aa, Ha, Ha, Ha, Ms, Ms, Ms
Ms, Ms, Ms, Ms, Ha, Ha, Aa, Aa, Aa^Feta, Aa, Aa, Re, Re, Aa, Aa, Aa, Aa, Aa, Ha, Ha, Ha, Ms, Ms, Ms
Ms, Ms, Ms, Ha, Ha, Ha, Aa, Aa, Aa, Aa, Aa^Vla, Aa, Re, Aa, Aa, Aa, Aa^Fda, Aa^Fda, Ha, Ha, Ha, Ms, Ms, Ms
Ms, Ms, Ms, Ha, Ha, Ha, Aa, Aa, Aa^Fda, Aa^Fda, Aa^Fda, Aa, Aa, Aa, Aa, Aa^Fda, Aa^Fda, Aa^Fda, Ha, Ha, Ha, Ms, Ms, Ms
Ms, Ms, Ms, Ha, Ha, Aa, Aa, Re, Aa^Fda, Aa^Fda, Aa^Fda, Aa, Aa, Re, Re, Aa, Aa, Aa, Aa, Ha, Ha, Ms, Ms, Ms
Ms, Ms, Ms, Ha, Ha, Aa, Re, Re, Aa^Fda, Aa^Fda, Aa^Fda, Aa, Aa, Re, Re, Aa, Aa, Aa, Aa, Ha, Ha, Ha, Ms, Ms
Ms, Ms, Ms, Ha, Ha, Aa, Aa, Aa, Aa, Aa^Fda, Aa, Aa, Aa, Re, Aa, Aa, Aa^Feta, Re, Aa, Ha, Ha, Ms, Ms, Ms
Ms, Ms, Ms, Ha, Ha, Aa, Aa, Aa, Aa, Aa, Aa, Aa, Re, Aa, Aa, Aa, Re, Re, Aa, Ha, Ha, Ms, Ms, Ms
Ms, Ms, Ms, Ha, Ha, Aa, Aa, Aa, Aa, Re, Re, Aa, Aa, Re, Re, Aa, Aa, Aa, Aa, Ha, Ha, Ms, Ms, Ms
Ms, Ms, Ms, Ha, Ha, Aa, Aa, Aa, Aa, Aa^Feta, Re, Aa, Aa, Re, Re, Aa, Aa, Aa, Aa^Fda, Ha, Ha, Ms, Ms, Ms
Ms, Ms, Ms, Ha, Ha, Aa, Aa, Aa^Vla, Aa^Fda, Aa, Aa, Aa, Re, Re, Re, Aa, Aa, Aa^Fda, Aa^Fda, Ha, Ha, Ms, Ms, Ms
Ms, Ms, Ms, Ha, Ha, Aa, Aa, Aa^Fda, Aa^Fda, Aa^Fda, Aa, Aa, Re, Re, Aa, Aa, Aa^Vla, Aa^Fda, Aa^Fda, Ha, Ha, Ms, Ms, Ms
Ms, Ms, Ms, Ha, Ha, Aa, Aa, Aa^Fda, Aa^Fda, Aa, Aa, Aa, Re, Re, Aa, Aa, Aa, Aa^Fda, Aa^Fda, Ha, Ha, Ms, Ms, Ms
Ms, Ms, Ms, Ha, Ha, Aa, Aa, Aa^Fda, Aa, Aa, Aa, Re, Re, Aa, Aa, Aa, Aa, Aa, Aa, Ha, Ha, Ms, Ms, Ms
Ms, Ms, Ms, Ha, Ha, Aa, Aa^Feta, Aa, Re, Aa, Aa, Re, Re, Aa, Aa, Aa, Re, Re, Aa, Ha, Ha, Ms, Ms, Ms
Ms, Ms, Ms, Ha, Ha, Aa, Aa, Re, Re, Aa, Aa, Re, Aa, Aa, Aa, Aa, Aa, Aa, Aa, Ha, Ha, Ms, Ms, Ms
Ms, Ms, Ms, Ha, Ha, Aa^Fda, Aa^Fda, Aa, Aa, Aa, Re, Re, Aa, Aa, Aa, Aa^Vla, Aa, Aa^Fda, Aa^Fda, Ha, Ha, Ms, Ms, Ms
Ms, Ms, Ms, Ha, Ha, Aa^Fda, Aa^Fda, Aa, Aa, Aa, Aa, Re, Re, Aa, Aa, Aa, Aa, Aa^Fda, Aa, Ha, Ha, Ms, Ms, Ms
Ms, Ms, Ms, Ha, Ha, Aa^Fda, Aa, Aa, Aa, Aa, Aa, Re, Re, Aa, Aa, Aa, Aa, Aa, Aa, Hh, Hh, Ms, Ms, Ms
Ms, Ms, Ms, Ha, Ha, Aa^Fda, Aa^Fda, Aa, Aa, Aa, Gg, Re, Re, Aa, Aa, Aa, Aa, Aa, Gs^Fds, Hh, Hh, Ms, Ms, Ms
Ms, Ms, Ms, Ha, Gg^Fds, Aa^Fda, Aa^Fda, Aa, Gg, Gg, Gg, Gg, Gg, Gg, Gg, Aa, Aa, Gs^Fds, Gs^Fds, Hh, Hh, Mm, Mm, Mm
Mm, Ms, Mm, Ha, Hh, Gg^Fds, Gg^Fds, Rr^Vd, Gg, Gg, Gg, Gg, Gg, Gg, Gg, Gg, Gg, Gs^Fds, Gs^Fds, Hh, Hh, Mm, Mm, Mm
Mm, Mm, Mm, Hh, Hh, Gs^Fds, Gs^Fds, Gg, Gg, Gg, Gg, Gg, Gg, Gg, Gg, Gg, Rr^Vd, Gs^Fds, Gs^Fds, Hh, Hh, Mm, Mm, Mm
Mm, Mm, Mm, Mm, Hh, Gs^Fds, Gs^Fds, Gg, Gg, Gg, Gg, Gg, Gg, Gg, Gg, Gg, Gg, Gs^Fds, Gg^Fet, Hh, Hh, Mm, Mm, Mm
Mm, Mm, Mm, Mm, Hh, Gs^Fds, Gs^Fds, Gg, Gg, Gg, Gg, Gg, Ce, Gg, Gg, Gg, Gg, Gs^Fds, Gs^Fds, Hh, Hh, Mm, Mm, Mm
Mm, Mm, Mm, Hh, Hh, Gs^Fds, Gs^Fds, Gg, Gg, Gg, Gg, Ce, 1 Ke, Ce, Gg, Gg, Gs^Fds, Gs^Fds, Gs^Fds, Hh, Hh, Mm, Mm, Mm
Mm, Mm, Mm, Hh, Hh, Gs^Fds, Gs^Fds, Gs^Fds, Rr^Vd, Gg, Gg, Ce, Ce, Ce, Gg, Gs^Fds, Gs^Fds, Gs^Fds, Hh, Hh, Hh, Mm, Mm, Mm
Mm, Mm, Mm, Hh, Hh, Hh, Gs^Fds, Gs^Fet, Gs^Fds, Gg, Gg, Gg, Gg, Gg, Gs^Fds, Gs^Fds, Hh, Hh, Hh, Hh, Mm, Mm, Mm, Mm
Mm, Mm, Mm, Mm, Mm, Hh, Hh, Gs^Fds, Gs^Fds, Gs^Fds, Gg, Gg, Gg, Gg, Gs^Fds, Gs^Fds, Mm, Hh, Mm, Mm, Mm, Mm, Mm, Mm
Mm, Mm, Mm, Mm, Mm, Mm, Mm, Gs^Fds, Gs^Fds, Gs^Fds, Gg, Gg, Gg, Gg, Gg, Gs^Fds, Mm, Mm, Mm, Mm, Mm, Mm, Mm, Mm
