Mm, Mm, Mm, Mm, Mm, Mm, Mm, Mm, Mm, Mm, Mm, Mm, Mm, Mm, Mm, Mm, Mm, Mm, Mm, Mm, Mm, Mm, Mm, Mm, Mm, Mm, Mm, Mm, Mm, Mm, Mm, Mm, Mm, Mm, Mm, Mm, Mm, Mm, Hh, Hh, Hh, Gg, Re, Gg, Gg, Gg, Wwf, Wo, Wo, Wwf, Wwf, Gg, Gg, Gs^Fds, Gs^Fds, Gs^Fds, Gg, Gg, Gg, Gs^Fds, Gs^Fds, Gs^Fds
Mm, Mm, Mm, Mm, Mm, Mm, Mm, Mm, Mm, Mm, Mm, Mm, Mm, Mm, Mm, Hh^Vhh, Mm, Mm, Mm, Mm, Mm, Mm, Mm, Mm, Mm, Mm, Mm, Mm, Mm, Mm, Mm, Mm, Hh, Mm, Hh, Mm, Hh, Hh, Hh, Hh, Gg, Gg, Re, Gg, Gg, Wwf, Wwf, Ww, Ww^Ewl, Wo, Ww, Wwf, Wwf, Wwf, Wwf, Wwf, Wwf, Wwf, Wwf, Wwf, Wwf, Wwf
Hh, Hh, Hh, Hh, Hh, Hh^Vhh, Hh, Mm, Mm, Mm, Mm, Mm, Mm, Mm, Mm, Mm, Mm, Mm, Mm, Mm, Mm, Mm, Mm, Mm, Hh, Mm, Hh, Hh, Hh, Hh, Hh, Hh, Hh, Hh, Hh, Hh, Hh, Hh, Hh, Hh, Re, Re, Gg, Gg^Efm, Gg, Gg, Wwf, Ww, Ww, Ww, Ww, Ww, Ww, Ww, Wo, Ww, Ww, Ww, Ww, Ww, Ww, Ww
Hh, Hh^Vhh, Hh, Hh, Hh, Hh, Hh, Hh, Hh, Hh, Hh, Hh, Cf, Cf, Cf, Hh, Hh, Hh, Hh, Hh, Hh, Hh, Hh^Vhh, Hh, Hh, Hh, Hh, Hh, Hh, Hh^Vhh, Hh, Hh, Hh, Hh, Gg^Es, Hh, Gg^Es, Gg^Es, Gg^Es, Re, Gg, Gg, Gg, Gg, Gg, Gg, Gg, Wwf, Wwf, Ww, Wwf, Ww, Wwf, Ww, Ww, Wo, Ww, Ww^Ewl, Ww, Ww^Ewl, Wo, Wo
Gg, Hh, Hh, Hh, Hh, Hh, Hh, Hh, Hh, Hh, Hh, Hh, Cf, 4 Kf, Cf, Hh, Hh, Hh, Hh, Hh, Hh, Hh, Hh, Hh, Hh, Hh, Hh, Hh, Hh, Hh, Gg, Hh, Gg, Gg, Gg, Gg^Es, Re, Re, Re, Re, Gg, Gg, Gg, Gg, Gg, Gg, Gg, Gg, Gg, Wwf, Gg^Es, Wwf, Gg, Wwf, Wwf, Ww, Wwf, Ww, Wwf, Ww, Wwf, Wwf
Re, Gg, Gg^Es, Gg^Es, Gg^Es, Hh, Hh, Hh, Hh, Hh, Hh, Hh, Cf, Cf, Hh, Hh, Hh^Vhh, Hh, Hh, Hh, Hh, Hh, Hh, Hh, Hh, Hh, Hh, Hh, Gg, Gg, Gg, Gg, Hh, Gg^Efm, Mm, Mm, Hh, Hh, Re, Gg, Gg^Es, Gg, Gg, Gg, Gg^Wm, Gg, Gg, Gg, Re, Re, Re, Re, Re, Gg, Gg, Wwf, Gg, Wwf, Hh, Hh, Mm, Hh
Gg, Re, Re, Gg, Gg, Gg^Es, Gg^Es, Hh^Es, Gg, Hh, Hh, Hh, Hh, Hh, Hh, Hh, Hh, Hh, Hh, Hh, Hh, Hh, Hh, Hh, Hh, Hh, Gg^Es, Gg^Es, Gg^Es, Gg, Gg, Gg, Hh, Mm, Mv, Mm, Gs^Fp, Gs^Fp, Re, Re, Gg, Gg, Gg, Gg, Gg, Gg, Re, Re, Hh, Hh, Gg^Fet, Gg^Efm, Gg, Re, Re, Re, Re, Gg, Gg^Fet, Mm, Mv, Mm
Gg, Gg, Gg, Re, Re, Gg, Gg, Gg^Es, Gg^Es, Gg^Es, Gg, Gg, Gg, Hh, Gg, Hh, Gg, Hh, Hh, Hh, Hh, Hh, Gg, Gg^Es, Gg^Es, Gg^Es, Gg^Es, Gg, Gg, Gg, Gg, Gg, Gg^Fet, Mm, Mm, Mm, Gs^Fp, Gs^Fp, Gg, Re, Re, Gg, Gg, Gg, Re, Re, Gg, Gg, Gs^Fp, Mm, Hh, Hh, Gg^Es, Re, Gg, Gg, Gg, Re, Rr^Vd, Hh, Mm, Mm
Gg, Gg, Gg, Gg, Re, Re, Gg, Gg, Re, Gg, Gg, Gg, Gg, Gg, Gg, Gg, Gg, Gg, Gg, Gg, Gg, Gg, Gg, Gg, Gg, Gg, Gg, Gg, Gg, Gg, Gg, Gg, Gg, Hh, Re, Hh, Re, Gg, Re, Re, Re, Re, Re, Re, Gg^Fet, Gg, Gg, Gg, Gg, Gg^Efm, Gg^Es, Gg^Es, Gg, Re, Gg, Gg, Gg, Re, Re, Hh, Hh, Hh
Re, Re, Re, Re, Gg, Re, Re, Re, Gg, Re, Re, Gg, Gg, Gg, Gg, Gg, Gg, Gg, Gg, Gg, Gg, Gg, Gg, Gg, Gg, Gg, Gg, Gg, Gg, Gg, Gg, Gg, Re, Re, Re, Re, Gg, Re, Gg, Gg, Gg, Re, Gs^Fp, Gs^Fp, Gs^Fp, Gs^Fp, Gg, Gg, Gg, Gg, Gg, Gg, Gg, Re, Gg, Gg, Gg, Gg, Gg, Re, Re, Gg
Gs^Fds, Gs^Fds, Gs^Fds, Gg, Gs^Fds, Gg, Re, Gg, Gg^Efm, Gg, Gg, Re, Re, Gg, Re, Gg, Re, Re, Re, Re, Re, Gg, Gg, Gg, Gg, Gg, Gg, Gg, Gg, Gg, Re, Re, Gg, Gg, Gg^Es, Gg, Gg^Efm, Gg, Gg, Gg, Gg, Re, Hh, Mm, Hh, Gs^Fp, Gg, Gg, Gg, Gg, Gg, Gg, Gg, Re, Gg, Gg, Gg, Gg, Ce, Gg, Gg, Re
Gs^Fds, Gs^Fds, Gs^Fds, Gs^Fds, Gs^Fds, Gs^Fds, Re, Gs^Fds, Gs^Fds, Gg, Gs^Fds, Gg, Gg, Re, Gg, Re, Gg, Gg, Gg, Gg, Gg, Re, Re, Gg, Re, Gg, Re, Gg, Re, Re, Gg, Gg, Gg, Gg^Es, Gg^Es, Gg^Es, Gg, Gg, Gg, Gg, Re, Re, Gg, Gg, Gg, Hh, Gg, Gg, 2 Gg, Gg, Gg, Gg, Gg, Re, Re, Gg, Gg, Ce, 1 Ke, Ce, Gg, Gg
Gs^Fds, Gs^Fds, Gs^Fds, Gs^Fds, Gs^Fds, Gs^Fds, Re, Gs^Fds, Gs^Fds, Gs^Fds, Gs^Fds, Gs^Fds, Gs^Fds, Gs^Fds, Gs^Fds, Gs^Fds, Gs^Fds, Gs^Fds, Gs^Fds, Gg, Gs^Fds, Re, Gs^Fds, Re, Gg, Re, Re, Re, Re, Gg, Gg, Gg, Gg, Gg^Es, Gg, Gg, Gg, Gg, Gg^Fet, Gg, Re, Gg, Gg, Gg, Gg, Gg, Gg, Gg, Gg, Gg, Gg, Gg, Gg, Gg, Re, Gg, Gg, Ce, Ce, Ce, Gg, Gg
Gs^Fds, Gs^Fds, Gs^Fds, Gs^Fds, Gs^Fds, Gs^Fds, Re, Re, Gs^Fds, Gg^Ve, Gs^Fds, Gs^Fds, Gs^Fds, Gs^Fds, Gs^Fds, Gs^Fds, Gs^Fds, Gs^Fds, Gs^Fds, Gs^Fds, Re, Re, Re, Gs^Fds, Gs^Fds, Gg, Gg, Gg, Re, Re, Gg, Gg, Gg, Gg, Gg, Gg, Hh, Mm, Hh, Hh, Re, Gg, Gg^Es, Gg, Gg^Es, Gg^Es, Gg, Gg, Gg, Gg, Gg, Gg, Gg, Gg, Re, Re, Re, Gg, Gg, Gg, Gg, Gg
Gs^Fds, Gs^Fds, Gg^Ve, Gs^Fds, Gs^Fds, Gs^Fds, Gs^Fds, Re, Gs^Fds, Gs^Fds, Gs^Fds, Gs^Fds, Gs^Fds, Gs^Fds, Gs^Fds, Gs^Fds, Gs^Fds, Gs^Fds, Gs^Fds, Re, Gs^Fds, Gs^Fds, Gs^Fds, Re, Re, Gs^Fds, Gs^Fds, Gg, Gg, Re, Re, Gg, Re, Gg, Gg, Gg, Gs^Fp, Gs^Fp, Gs^Fp, Hh, Hh, Re, Gg, Gg^Es, Re, Gg^Es, Re, Gg, Re, Re, Re, Re, Re, Re, Gg, Re, Re, Gg, Gg, Gg, Gg, Gg
Gs^Fds, Gs^Fds, Gs^Fds, Gs^Fds, Gs^Fds, Gs^Fds, Gs^Fds, Re, Gs^Fds, Gs^Fds, Gs^Fds, Gs^Fds, Gs^Fds, Gs^Fds, Gs^Fds, Gs^Fds, Gs^Fds, Gs^Fds, Re, Re, Gs^Fds, Gs^Fds, Gs^Fds, Gs^Fds, Re, Gs^Fds, Gs^Fds, Gg, Gg, Gg, Gg, Re, Gg, Re, Re, Gg, Gg^Efm, Gs^Fp, Gs^Fp, Gs^Fp, Re, Re, Re, Re, Gg, Re, Gg, Re, Gg^Wm, Gg, Gg, Gg, Gg, Gg, Gg, Gg^Es, Re, Gg, Gg, Gg, Gs^Fds, Gs^Fds
Gs^Fds, Gs^Fds, Gs^Fds, Gs^Fds, Gs^Fds, Gs^Fds, Gs^Fds, Re, Gs^Fds, Gs^Fds, Gs^Fds, Gs^Fds, Gs^Fds, Gs^Fds, Gg^Ve, Gs^Fds, Gs^Fds, Gs^Fds, Re, Gs^Fds, Gs^Fds, Gs^Fds, Gs^Fds, Gs^Fds, Re, Gs^Fds, Gs^Fds, Gg^Efm, Gs^Fds, Gg, Gs^Fds, Gg, Gg, Gg, Gg, Re, Re, Gg^Efm, Re, Re, Re, Gg, Gg, Gg, Gg, Gg, Gg, Gg, Gg, Gg, Gg, Gg^Es, Gg^Es, Gg^Es, Gg^Es, Gg^Es, Re, Gg, Gg, Rr^Vd, Gs^Fds, Gs^Fds
Re, Gs^Fds, Gs^Fds, Gs^Fds, Gs^Fds, Gs^Fds, Gs^Fds, Re, Re, Gs^Fds, Gs^Fds, Gs^Fds, Gs^Fds, Gs^Fds, Gs^Fds, Gs^Fds, Re, Re, Gs^Fds, Gs^Fds, Gs^Fds, Gs^Fds, Gs^Fds, Gs^Fds, Gs^Fds, Re, Gs^Fds, Gs^Fds, Gs^Fds, Gs^Fds, Gs^Fds, Gs^Fds, Gs^Fds, Gg, Gg, Gg, Re, Re, Re, Re, Gg, Gg, Gg, Gg, Gg, Gg, Gg^Efm, Gg^Efm, Gg, Gg, Gg, Gg, Gg, Gg^Es, Gg, Gg, Re, Gg, Gg, Gs^Fds, Gs^Fds, Gs^Fds
Gs^Fds, Re, Re, Gs^Fds, Gs^Fds, Gs^Fds, Gs^Fds, Re, Re, Gs^Fds, Gs^Fds, Gs^Fds, Gs^Fds, Gs^Fds, Gs^Fds, Gs^Fds, Re, Gs^Fds, Gs^Fds, Gs^Fds, Gs^Fds, Gs^Fds, Gg^Ve, Gs^Fds, Gs^Fds, Re, Re, Gs^Fds, Re, Gs^Fds, Gs^Fds, Gs^Fds, Gs^Fds, Gg, Re, Re, Hh, Gg, Gg^Fet, Gg, Gs^Fp, Gg, Mm, Gg, Gg, Gg, Hh, Hh, Gg^Fet, Gg, Gg, Gg, Gg, Gg, Gg, Gg, Re, Gg^Efm, Gg, Gs^Fds, Gs^Fds, Gs^Fds
Gs^Fds, Gs^Fds, Re, Gs^Fds, Cv, Cv, Cv, Gs^Fds, Gs^Fds, Re, Re, Gs^Fds, Gs^Fds, Gs^Fds, Re, Re, Gs^Fds, Gs^Fds, Gs^Fds, Gs^Fds, Gs^Fds, Gs^Fds, Gs^Fds, Gs^Fds, Gs^Fds, Gs^Fds, Re, Re, Wwf, Re, Wwf, Wwf, Wwf, Re, Gg, Hh, Gg^Ve, Gs^Fp, Hh, Gg^Tf, Gs^Fp, Hh, Gg, Gg, Gg, Gg, Gs^Fp, Mm, Hh, Hh, Gg, Gg^Efm, Gg, Gg, Gg, Gg, Re, Gg, Gg, Gs^Fds, Gs^Fds, Gs^Fds
Gs^Fds, Gs^Fds, Gs^Fds, Cv, Cv, 3 Kv, Cv, Cv, Gs^Fds, Gs^Fds, Re, Re, Re, Re, Gs^Fds, Re, Re, Gs^Fds, Gs^Fds, Gs^Fds, Gs^Fds, Gs^Fds, Gs^Fds, Gs^Fds, Gs^Fds, Re, Wwf, Wwf, Ww, Wwf, Ww, Ww, Ww^Ewl, Wwf, Wwf, Wwf, Wwf, Wwf, Wwf, Wwf, Wwf, Wwf, Wwf, Gg, Gs^Fms, Re, Re, Re, Re, Gg^Efm, Gg, Gg, Gg, Gg, Re, Re, Gg, Gg, Gs^Fds, Gs^Fds, Gs^Fds, Gs^Fds
Gs^Fds, Gs^Fds, Gs^Fds, Gs^Fds, Gs^Fds, Cv, Gs^Fds, Gs^Fds, Re, Re, Gs^Fds, Gs^Fds, Gs^Fds, Gs^Fds, Gs^Fds, Gs^Fds, Gs^Fds, Re, Re, Re, Re, Gs^Fds, Re, Gs^Fds, Wwf, Wwf, Ww, Ww^Ewl, Ww, Ww, Ww, Ww, Wwf, Ww, Ww, Ww, Ww, Ww, Ww, Ww, Wo, Ww, Ww, Wwf, Wwf, Gs^Fms, Gs^Fms, Gg, Gs^Fms, Re, Re, Gg, Gg, Gg, Re, Gg, Gg, Gg, Gs^Fds, Gs^Fds, Gs^Fds, Gs^Fds
Gs^Fds, Gs^Fds, Gs^Fds, Gs^Fds, Gs^Fds, Gs^Fds, Re, Re, Gs^Fds, Gs^Fds, Gs^Fds, Gs^Fds, Gs^Fds, Gs^Fds, Gs^Fds, Gs^Fds, Gs^Fds, Gs^Fds, Re, Re, Gs^Fds, Re, Gs^Fds, Ww^Bw\, Ww^Bw\, Ww, Ww, Ww, Wwf, Wwf, Gs^Fds, Wwf, Re, Ww^Ewf, Ww, Ww, Wwf, Ww, Wwf, Wo, Ww, Ww, Ww, Ww, Ww, Wwf, Wwf, Gs^Fms, Wwf, Gs^Fms, Gg, Re, Re, Re, Gg, Re, Re, Gg, Gs^Fds, Gs^Fds, Gs^Fds, Gs^Fds
Gs^Fds, Gs^Fds, Gs^Fds, Gs^Fds, Gs^Fds, Re, Re, Gs^Fds, Gs^Fds, Gs^Fds, Gs^Fds, Gs^Fds, Gs^Fds, Gs^Fds, Gs^Fds, Gs^Fds, Gs^Fds, Re, Re, Gs^Fds, Gs^Fds, Gs^Fds, Wwf, Wwf, Ww, Ww^Bw\, Ww^Bw\, Wwf, Re, Re, Re, Re, Gs^Fds, Gs^Fds, Gs^Fds, Wwf, Gs^Fds, Wwf, Gs^Fds, Wwf, Wwf, Wwf, Wwf, Ww, Ww, Ww, Ww, Wwf, Ww, Wwf, Ww^Bw/, Re, Gg, Gg, Gg^Efm, Gg, Gg, Re, Re, Gs^Fds, Gs^Fds, Gs^Fds
Gg^Ve, Gs^Fds, Gs^Fds, Gs^Fds, Re, Re, Gs^Fds, Gs^Fds, Gs^Fds, Gs^Fds, Gs^Fds, Gs^Fds, Gg^Ve, Gs^Fds, Gs^Fds, Gs^Fds, Gs^Fds, Re, Gs^Fds, Gs^Fds, Wwf, Wwf, Ww^Ewl, Ww, Ww, Wwf, Gs^Fds, Re, Gs^Fds, Gs^Fds, Gs^Fds, Gg^Ve, Gs^Fds, Gs^Fds, Gs^Fds, Gs^Fds, Gs^Fds, Gs^Fds, Gs^Fds, Gs^Fds, Gs^Fds, Gs^Fds, Gs^Fds, Wwf, Wwf, Ww^Ewl, Ww^Ewf, Ww, Ww^Bw/, Ww^Bw/, Ww, Wwf, Wwf, Gg, Gg, Gg, Gs^Fds, Gs^Fds, Gs^Fds, Re, Re, Gs^Fds
Gs^Fds, Gs^Fds, Gs^Fds, Re, Gs^Fds, Gs^Fds, Gs^Fds, Gs^Fds, Gs^Fds, Gs^Fds, Gs^Fds, Gs^Fds, Gs^Fds, Gs^Fds, Gs^Fds, Gs^Fds, Re, Re, Gs^Fds, Wwf, Ww, Ww^Ewl, Ww, Ww, Wwf, Wwf, Gs^Fds, Gs^Fds, Gs^Fds, Gs^Fds, Gs^Fds, Gs^Fds, Gs^Fds, Gs^Fds, Gs^Fds, Gs^Fds, Gs^Fds, Gs^Fds, Gs^Fds, Gs^Fds, Gs^Fds, Gs^Fds, Gs^Fds, Gs^Fds, Gs^Fds, Gs^Fds, Gs^Fds, Re, Wwf, Ww, Ww, Ww, Wwf, Gg, Gs^Fds, Gs^Fds, Gs^Fds, Gs^Fds, Gs^Fds, Gs^Fds, Re, Gs^Fds
