Wot, Wot, Wot, Wo, Wo, Wo, Wo, Wo, Wo, Ww, Ww, Gg, Ww^Vm, Cv, Kv, Cv, Gs^Fds, Ds, Ww, Ww, Wo, Wo, Wo, Wo, Wo, Ww, Ds, Gg, Gg^Ve, Gg
Wot, Wot, Wot, Wot, Wot, Wo, Wo, Wo, Wo, Ww, Ww, Ww, Gs^Fds, Gg^Ve, Cv, Gg^Ve, Ds, Ds, Ww, Wo, Wo, Wo, Wo, Wo, Wo, Ww, Ww, Gg, Ww, Gg
Wot, Wot, Wot, Wot, Wo, Wo, Wo, Wo, Wo, Wo, Wo, Ww, Ww, Gs^Fds, Ds, Gs^Fds, Ds, Wwr, Ww, Wo, Wo, Wo, Wo, Wo, Wo, Ww, Ds, Ww, Ww, Ww
Wot, Wot, Wot, Wot, Wo, Wo, Wo, Wo, Wo, Wo, Wo, Ww, Ww, Ds, Ww^Vm, Ds, Wwr, Wwr, Wwr, Wo, Wo, Wo, Wo, Wo, Ww, Ww, Ds, Gg, Gg, Ww
Wot, Wot, Wot, Wot, Wot, Wo, Wo, Wo, Wo, Wo, Wo, Ww, Ww, Ww, Ww, Ds, Ww, Ww, Wwr, Wo, Wo, Wo, Wo, Wo, Ww, Ww^Vm, Gg, Gg, Gg, Gg^Ve
Wot, Wot, Wot, Wot, Wot, Wo, Wo, Wo, Wo, Wo, Wo, Wo, Ww, Ww, Ww, Wwr, Ds, Ww, Ww, Wwr, Ww, Wo, Wo, Wo, Ww, Ds, Gg, Gg^Ve, Gg, Gg
Wot, Wot, Wot, Wot, Wot, Wot, Wot, Wo, Wo, Wo, Wo, Wo, Wo, Ww, Ww, Ds, Ds, Ww^Vm, Ww, Wwr, Wwr, Wo, Wo, Wo, Ww^Vm, Ds, Gg, Gg, Gg, Gg
Wot, Wot, Wot, Wot, Wot, Wot, Wot, Wot, Wo, Wo, Wo, Wo, Wo, Ww, Ww, Wwr, Ww, Ww, Ww, Wwr, Ww, Ww, Wo, Ww, Ds, Ds, Gg, Gg, Cv, Cv
Wot, Wot, Wot, Wot, Wot, Wot, Wot, Wot, Wot, Wo, Wo, Wo, Wo, Wo, Ww, Ww, Ww, Wwr, Wwr, Ww, Ww^Vm, Ww, Ww, Ww, Ds, Ds, Gg, Gg, Cv, Kv
Wot, Wot, Wot, Wot, Wot, Wot, Wot, Wot, Wo, Wo, Wo, Wo, Wo, Wo, Ww, Ww, Ww, Wwr, Wwr, Ds, Ww, Ww, Ww, Ww, Ds, 1 Gg, Gg, Gg, Gg, Cv
Wot, Wot, Wot, Wot, Wot, Wot, Wot, Wot, Wo, Wot, Wot, Wo, Wo, Wo, Ww, Ww, Ww, Ww, Ww, Wwr, Ww, Ww, Ww, Ds, Gg, Gg^Ve, Gg, Gg, Gg, Gg
Wot, Wot, Wot, Wot, Wot, Wot, Wot, Wot, Wot, Wot, Wot, Wo, Wo, Wo, Wo, Ww, Ww^Vm, Ww, Ww, Wwr, Wwr, Ww, Ds, Ds, Gs, Gg, Gg, Gg, Gg, Gg
