Ww, Ww, Ww, Ss, Ss, Ss, Ss, Ss, Ss, Rd, Chr, Gg, Gg, Hh, Hh, Hh, Mm, Mm, Hh, Hh, Hh, Rr, Rd, Gs^Fds, Rd, Ss, Ww, Ss, Ss, Gs, Rd, Gs, Gs, Gs, Ss, Gs, Gs^Fds
Ss, Ss, Ss, Ss, Ss, Ss, Ss^Vhs, Rd, Rd, Chr, Khr, Ss, Ss, Gs^Fds, Gs^Fds, Hh^Fds, Hh^Fds, Hh, 1 Hh, Rd, Rd, Rd, Ss, Ss, Rd, Ss, Ww, Ww, Ss, Ss, Gg, Gg^Vh, Ss, Gs, Gs^Fds, Gs^Fds, Gs^Fds
Gs^Fds, Gs^Fds, Gg, Gg, Gs^Fds, Ss, Ss, Ss, Ss, Ss, Chr, Chr, Rd, Ss, Rd, Hh^Fds, Gs^Fds, Rd, Gs^Fds, Rd, Gg, Gg^Vh, Gg, Ss, Ss, Ss, Ww, Ww, Ss, Gg, Ss, Ss, Ww, Ss, Gs^Fds, Gs^Fds, Gs^Fds
Gg, Gg, Ss^Vhs, Ss, Gs^Fds, Gs^Fds, Ss, Ww, Ww, Ss, Ss, Gg, Ss, Ss^Vhs, Ss, Rd, Gs^Fds, Gs^Fds, Gs^Fds, Rd, Gg, Gg, Ss, Ss, Ww, Ww, Ss, Ww, Ww, Ss, Ww, Ww, Ww, Ss, Gs^Fds, Ss, Ss
Ss, Ss, Ss, Ss, Gs^Fds, Gs^Fds, Ss, Ss, Ss, Ss, Ss, Ss, Gg, Ss, Gs^Fds, Hh^Fds, Gg, Hh^Fds, Gg, Gg, Ss, Ss, Ss, Ww, Ss, Ss, Gs^Fds, Ss, Ss, Ww, Ss, Ss, Ss, Ss, Ss^Vhs, Ss, Ss
Gs^Fds, Gs^Fds, Gs^Fds, Ss, Gs^Fds, Ss, Gs^Fds, Gs^Fds, Ss, Gg, Ss^Vhs, Ss, Ss, Ss, Ss, Ss, Ss, Hh^Fds, Ss, Ss, Ss, Ss, Gg, Ss, Gg, Ss, Gg, Gs^Fds, Ss, Ss^Vhs, Ss, Gs^Fds, Gs^Fds, Ss, Ss, Ww, Ww
Gs^Fds, Gs^Fds, Gs^Fds, Gs^Fds, Gs^Fds, Ss, Gs^Fds, Ss, Ss, Gg, Gg, Ss, Ww, Ww, Ww, Ss, Ss, Ss, Gg^Vh, Ss, Ww, Ss, Ss, Ss, Ss, Ss, Ss, Ss, Ss, Ss, Gs, Gs^Fds, Ss, Ss, Ss, Ww, Ww
Gs^Fds, Gs^Fds, Gs^Fds, Gs^Fds, Gs^Fds, Gs^Fds, Gs^Fds, Gg, Ss, Ss, Ss, Ss, Ww, Ww, Ww, Ss, Ss, Gg, Gg, Ss, Ww, Ww, Ss, Ss, Gg, Gg, Ss, Ss, Ss, Gs, Gs, Gs^Fds, Gs^Fds, Gs^Fds, Ss, Ss, Ss
